Afghanistan: Kabul
Albania: Tirana
Algeria: Algiers
Andorra: Andorra la Vella
Angola: Luanda
Antigua and Barbuda: Saint John's; Saint Johns; St. John's; St. Johns; St John's; St Johns
Argentina: Buenos Aires
Armenia: Yerevan
Australia: Canberra
Austria: Vienna
Azerbaijan: Baku
Bahamas: Nassau
Bahrain: Manama
Bangladesh: Dhaka
Barbados: Bridgetown
Belarus: Minsk
Belgium: Brussels
Belize: Belmopan
Benin: Porto-Novo
Bhutan: Thimphu
Bolivia: La Paz; Sucre
Bosnia and Herzegovina: Sarajevo
Botswana: Gaborone
Brazil: Brasilia
Brunei: Bandar Seri Begawan
Bulgaria: Sofia
Burkina Faso: Ouagadougou
Burundi: Gitega
Cambodia: Phnom Penh
Cameroon: Yaounde
Canada: Ottawa
Cape Verde: Praia
Central African Republic: Bangui
Chad: N'Djamena; Ndjamena
Chile: Santiago
China: Beijing
Colombia: Bogota
Comoros: Moroni
Costa Rica: San Jose
Croatia: Zagreb
Cuba: Havana
Cyprus: Nicosia
Czech Republic: Prague
Democratic Republic of the Congo: Kinshasa
Denmark: Copenhagen
Djibouti: Djibouti; Djibouti City
Dominica: Roseau
Dominican Republic: Santo Domingo
East Timor: Dili
Ecuador: Quito
Egypt: Cairo
El Salvador: San Salvador
Equatorial Guinea: Malabo
Eritrea: Asmara
Estonia: Tallinn
Eswatini: Mbabane
Ethiopia: Addis Ababa
Fiji: Suva
Finland: Helsinki
France: Paris
Gabon: Libreville
The Gambia: Banjul
Georgia: Tbilisi
Germany: Berlin
Ghana: Accra
Greece: Athens
Grenada: Saint George's; Saint Georges; St. George's; St. Georges; St George's; St Georges
Guatemala: Guatemala City
Guinea: Conakry
Guinea-Bissau: Bissau
Guyana: Georgetown
Haiti: Port-au-Prince
Honduras: Tegucigalpa
Hungary: Budapest
Iceland: Reykjavik
India: New Delhi
Indonesia: Jakarta
Iran: Tehran
Iraq: Baghdad
Ireland: Dublin
Israel: Jerusalem
Italy: Rome
Ivory Coast: Yamoussoukro
Jamaica: Kingston
Japan: Tokyo
Jordan: Amman
Kazakhstan: Astana; Nur-Sultan
Kenya: Nairobi
Kiribati: Tarawa
Kosovo: Pristina
Kuwait: Kuwait City
Kyrgyzstan: Bishkek
Laos: Vientiane
Latvia: Riga
Lebanon: Beirut
Lesotho: Maseru
Liberia: Monrovia
Libya: Tripoli
Liechtenstein: Vaduz
Lithuania: Vilnius
Luxembourg: Luxembourg
Macedonia: Skopje
Madagascar: Antananarivo
Malawi: Lilongwe
Malaysia: Kuala Lumpur
Maldives: Male
Mali: Bamako
Malta: Valletta
Marshall Islands: Majuro
Mauritania: Nouakchott
Mauritius: Port Louis
Mexico: Mexico City
Micronesia: Palikir
Moldova: Chisinau
Monaco: Monaco
Mongolia: Ulaanbaatar
Montenegro: Podgorica
Morocco: Rabat
Mozambique: Maputo
Myanmar: Naypyidaw
Namibia: Windhoek
Nauru: Yaren
Nepal: Kathmandu
Netherlands: Amsterdam
New Zealand: Wellington
Nicaragua: Managua
Niger: Niamey
Nigeria: Abuja
North Korea: Pyongyang
Norway: Oslo
Oman: Muscat
Pakistan: Islamabad
Palau: Ngerulmud
Panama: Panama City
Papua New Guinea: Port Moresby
Paraguay: Asuncion
Peru: Lima
Philippines: Manila
Poland: Warsaw
Portugal: Lisbon
Qatar: Doha
Republic of the Congo: Brazzaville
Romania: Bucharest
Russia: Moscow
Rwanda: Kigali
Saint Kitts and Nevis: Basseterre
Saint Lucia: Castries
Saint Vincent and the Grenadines: Kingstown
Samoa: Apia
San Marino: San Marino
Sao Tome and Principe: Sao Tome
Saudi Arabia: Riyadh
Senegal: Dakar
Serbia: Belgrade
Seychelles: Victoria
Sierra Leone: Freetown
Singapore: Singapore
Slovakia: Bratislava
Slovenia: Ljubljana
Solomon Islands: Honiara
Somalia: Mogadishu
South Africa: Pretoria/Cape Town/Bloemfontein; Pretoria; Cape Town; Bloemfontein
South Korea: Seoul
South Sudan: Juba
Spain: Madrid
Sri Lanka: Sri Jayawardenapura Kotte
Sudan: Khartoum
Suriname: Paramaribo
Sweden: Stockholm
Switzerland: Bern
Syria: Damascus
Taiwan: Taipei
Tajikistan: Dushanbe
Tanzania: Dodoma
Thailand: Bangkok
Togo: Lome
Tonga: Nuku'alofa
Trinidad and Tobago: Port-of-Spain; Port of Spain
Tunisia: Tunis
Turkey: Ankara
Turkmenistan: Ashgabat
Tuvalu: Funafuti
Uganda: Kampala
Ukraine: Kyiv; Kyev
United Arab Emirates: Abu Dhabi
United Kingdom: London
United States of America: Washington, D.C.; DC; D.C.; Washington DC; Washington D.C.; Washington
Uruguay: Montevideo
Uzbekistan: Tashkent
Vanuatu: Port Vila
Vatican City: Vatican City; Vatican
Venezuela: Caracas
Vietnam: Hanoi
Yemen: Sana'a; Sanaa
Zambia: Lusaka
Zimbabwe: Harare